11111111111111111111111
10000000P10000000100001
1000111111000E0001000C1
10001000000000000100001
10001001111100C00100111
10011000000100000101001
10000000C00100000000001
100C000000010000000C111
1000000C010000000000001
11111111111111111111111
